111111111111111
100000000000001
101111111111111
1K1111111111111
1K1111111111111
1K1111111111111
101111111111111
100000000LLLLL1
111111111111111
111111111111111