11111111111111
100000000001K1
10111101110101
10111101110101
10001100110K01
11101101111011
111KK111111K01
111K1LLLLLLL11
111K1K11111111
00001111111L11
111LLLLLLLLL11
11101111111KK0
1KKKKK00001111
11111111111111