111111111111
1000001LLLL1
1000001LLLL1
100000KLLLL1
100000KLLLL1
1000001LLLL1
1000001LLLL1
111111111111